type octile
height 24
width 53
map
@@@@@@@@@@@@@@@@@@@@@@@@@@@@@@@@@@@@@@@@@@@@@@@@@@@@@
@                                                   @
@       @@@@@@@@@@ @@@@@@@@@@ @@@@@@@@@@ @@@@@@@@@@ @
@ @@@   @@@@@@@@@@ @@@@@@@@@@ @@@@@@@@@@ @@@@@@@@@@ @
@ @@@                                               @
@ @@@   @@@@@@@@@@ @@@@@@@@@@ @@@@@@@@@@ @@@@@@@@@@ @
@       @@@@@@@@@@ @@@@@@@@@@ @@@@@@@@@@ @@@@@@@@@@ @
@ @@@                                               @
@ @@@   @@@@@@@@@@ @@@@@@@@@@ @@@@@@@@@@ @@@@@@@@@@ @
@ @@@   @@@@@@@@@@ @@@@@@@@@@ @@@@@@@@@@ @@@@@@@@@@ @
@                                                   @
@       @@@@@@@@@@ @@@@@@@@@@ @@@@@@@@@@ @@@@@@@@@@ @
@       @@@@@@@@@@ @@@@@@@@@@ @@@@@@@@@@ @@@@@@@@@@ @
@                                                   @
@ @@@   @@@@@@@@@@ @@@@@@@@@@ @@@@@@@@@@ @@@@@@@@@@ @
@ @@@   @@@@@@@@@@ @@@@@@@@@@ @@@@@@@@@@ @@@@@@@@@@ @
@ @@@                                               @
@       @@@@@@@@@@ @@@@@@@@@@ @@@@@@@@@@ @@@@@@@@@@ @
@       @@@@@@@@@@ @@@@@@@@@@ @@@@@@@@@@ @@@@@@@@@@ @
@ @@@                                               @
@ @@@   @@@@@@@@@@ @@@@@@@@@@ @@@@@@@@@@ @@@@@@@@@@ @
@ @@@   @@@@@@@@@@ @@@@@@@@@@ @@@@@@@@@@ @@@@@@@@@@ @
@                                                   @
@@@@@@@@@@@@@@@@@@@@@@@@@@@@@@@@@@@@@@@@@@@@@@@@@@@@@