type octile
height 24
width 53
map
@@@@@@@@@@@@@@@@@@@@@@@@@@@@@@@@@@@@@@@@@@@@@@@@@@@@@
@                                                   @
@       SSSSSSSSSS SSSSSSSSSS SSSSSSSSSS SSSSSSSSSS @
@ @@@   SSSSSSSSSS SSSSSSSSSS SSSSSSSSSS SSSSSSSSSS @
@ @@@                                               @
@ @@@   SSSSSSSSSS SSSSSSSSSS SSSSSSSSSS SSSSSSSSSS @
@       SSSSSSSSSS SSSSSSSSSS SSSSSSSSSS SSSSSSSSSS @
@ @@@                                               @
@ @@@   SSSSSSSSSS SSSSSSSSSS SSSSSSSSSS SSSSSSSSSS @
@ @@@   SSSSSSSSSS SSSSSSSSSS SSSSSSSSSS SSSSSSSSSS @
@                                                   @
@       SSSSSSSSSS SSSSSSSSSS SSSSSSSSSS SSSSSSSSSS @
@       SSSSSSSSSS SSSSSSSSSS SSSSSSSSSS SSSSSSSSSS @
@                                                   @
@ @@@   SSSSSSSSSS SSSSSSSSSS SSSSSSSSSS SSSSSSSSSS @
@ @@@   SSSSSSSSSS SSSSSSSSSS SSSSSSSSSS SSSSSSSSSS @
@ @@@                                               @
@       SSSSSSSSSS SSSSSSSSSS SSSSSSSSSS SSSSSSSSSS @
@       SSSSSSSSSS SSSSSSSSSS SSSSSSSSSS SSSSSSSSSS @
@ @@@                                               @
@ @@@   SSSSSSSSSS SSSSSSSSSS SSSSSSSSSS SSSSSSSSSS @
@ @@@   SSSSSSSSSS SSSSSSSSSS SSSSSSSSSS SSSSSSSSSS @
@                                                   @
@@@@@@@@@@@@@@@@@@@@@@@@@@@@@@@@@@@@@@@@@@@@@@@@@@@@@