type octile
height 6
width 3
map
@@@
@ @
@ @
@ @
@ @
@@@