type octile
height 4
width 7
map
.......
.@@@@@.
.@@@@@.
.......