type octile
height 6
width 4
map
....
.@..
.@..
.@..
.@..
....