type octile
height 5
width 9
map
....@....
....@....
.........
....@....
....@....