type octile
height 1
width 4
map
    