type octile
height 2
width 11
map
...........
@@@@@.@@@@@