type octile
height 3
width 4
map
@@.@
....
@.@@